112
7
7 0 0 0 0 0 0 0 0 0 0 0 0 0 0 0 0 0 0 0 13 0 0 0 0 0 0 0 0 0 0 0 0 30 17 14 14 14 18 17 14 14 14 14 14 14 14 14 14 14 14 14 18 17 14 14 14 14 14 14 14 14 14 14 14 18 31 31 32 0 0 0 0 0 0 0 0 0 0 0 0 0 0 0 0 0 0 0 0 0 0 0 0 0 0 0 30 17 14 14 14 18 31 31 31 31 31 31 31 31 31 17 
27 0 0 0 0 0 0 0 0 0 0 0 0 0 0 0 0 0 0 0 24 0 0 0 0 0 0 0 0 0 0 0 0 0 30 31 31 17 16 15 14 18 31 17 14 14 18 17 14 14 14 14 16 15 14 14 14 14 14 14 14 14 18 31 31 32 0 0 0 0 0 0 0 0 0 0 0 0 0 8 0 0 0 0 0 0 0 0 0 0 0 11 0 0 0 0 0 30 17 14 14 29 0 0 0 0 0 0 0 0 0 28 
29 0 0 0 0 0 0 0 0 0 0 0 0 0 0 0 8 0 0 0 0 0 0 0 0 0 0 0 0 0 0 0 0 0 0 0 0 28 14 18 31 32 0 30 31 17 16 15 14 14 14 14 14 14 14 14 18 17 14 14 18 31 32 0 0 0 0 0 0 0 0 0 0 0 0 0 3 0 21 22 23 0 0 0 0 0 0 0 7 25 26 27 0 0 0 0 0 0 30 31 17 29 0 0 0 0 0 0 0 0 0 28 
29 0 0 0 0 0 0 0 0 0 0 0 0 4 2 25 26 27 3 0 6 0 0 0 0 0 0 0 0 4 6 0 0 0 0 0 0 30 31 32 0 0 0 0 0 30 31 31 31 31 31 17 14 14 14 14 16 15 14 18 32 0 0 0 0 0 0 0 0 0 0 4 0 7 0 0 24 0 0 0 0 0 0 0 0 4 5 0 25 15 14 29 0 0 0 0 0 0 0 0 30 32 0 0 0 0 0 0 0 0 0 28 
29 0 0 0 0 0 0 0 7 0 0 0 25 26 26 15 14 16 26 26 27 0 0 0 0 0 0 0 25 26 26 27 0 0 0 0 0 0 0 0 0 0 0 0 0 0 0 0 0 0 0 30 31 31 31 31 31 31 31 32 0 0 0 0 0 0 0 0 0 0 21 22 22 23 0 0 0 0 0 0 0 0 0 25 26 26 26 26 15 18 17 29 0 0 0 0 0 0 0 0 0 0 0 0 0 0 0 0 0 0 0 28 
29 4 5 2 0 10 0 0 21 22 23 0 28 18 17 14 14 14 18 17 29 4 0 0 2 4 0 7 28 18 17 29 0 8 0 0 0 0 0 0 0 0 0 0 0 0 0 0 0 8 0 0 0 0 0 0 0 0 0 0 0 0 0 0 0 0 10 0 0 0 0 0 0 0 0 0 0 0 0 0 0 0 0 28 14 14 14 14 14 16 15 29 0 0 0 0 0 8 0 0 0 0 0 0 0 0 13 0 0 0 0 28 
16 26 26 26 26 26 27 0 0 0 0 0 28 16 15 14 14 14 16 15 16 26 26 26 26 26 26 26 15 16 15 16 26 26 27 0 0 33 34 34 35 0 0 33 34 34 34 34 34 34 34 34 34 34 34 34 34 34 34 34 34 34 34 34 34 34 34 34 35 0 0 0 0 0 0 0 0 0 0 0 0 0 0 28 14 14 14 14 14 14 14 29 0 0 0 33 34 34 34 34 34 34 34 34 34 34 34 34 34 34 34 15 
