13
7
14 14 18 31 31 31 31 31 31 31 31 31 17 
14 14 29 0 0 0 0 0 0 0 0 0 28 
14 14 29 0 0 0 0 0 0 0 0 0 28 
14 14 29 0 0 0 0 0 0 0 0 0 28 
14 14 29 0 0 0 0 0 0 0 0 0 28 
14 14 29 0 0 0 0 13 0 0 0 0 28 
14 14 16 34 34 34 34 34 34 34 34 34 15 
